####################
#    O#      ##    #
#     ###    O## X #
#    ####    ##    #
#    X  #          #
#                  #
#P    X            #
#         ##########
#   X     #O       #
#                 O#
#                  #
#    O  X   ########
#  X              O#
####################
