############  ##############
#  P O #O  #  #            #
# X   ##   #  #            #
###    # X #  #            #
#    X##   #  #            #
#  O       #  #            #
# X   X#####  #            #
# O       O#  #            #
############  ##############
